0000000000000000>;;8?00000000000000000000000000000 #
00000000000000000;;?000000000000000000000000000000 #
000000000000000007;0000000000000000000000000000000 #
BA0BB000000000000>40000000000000000000000000000000 #
:::::5000@0B0@000000000000000000000000000000000000 #
;;;;?0003::::5000000000000000000000000000000000000 #
;;;80000>7;;8?00@B0BA0B000000000000000000000000000 #
;;8?0000000000003:::::5000000000000000000000000000 #
;?000000000000000>;;;;?000000000000000000000000001 #