00000000000000000000000000000000000000000000000000 #
00000000000000000000000000000000000000000000000000 #
00000100000000000000000000000000000000000000000000 #
00000000000000000000000000000000000000000000000000 #
00000000000000000000000000000000000000000000000000 #
00000000000000000000000000000000000000000000000000 #
00010000000000000000000000000000000000000000000000 #
00000000000000000000000000000000000000000000000000 #
69010690690000000000000000000000000000000000000000 #