00000000000000000000000000000000000000000000000000 #
00000000000000000000000000000000000000000000000000 #
000000000003::::5000000000000000000000001000000000 #
00000000000>7;8?0000000000000000000000000000000000 #
00000000200000000000000000000000000001000000000000 #
00000000;<0000000000000000000000000000000000000000 #
00000200;90000000000000000000000001000000000000000 #
00000;<0;;<00000000003::::::9<0000000000000003:::: #
06:90;9<;;9<000000000000>7;;;::9000000000000000>7; #