0000000000000000>;;8?00000000>;;8?0000000000000000 # Easiest level
00000000000000000;;?00000000007;?00000000000000000 #
000000000000000007;00000000000>400000000A@0@AB0B0A #
BA0BB000000000000>4000000000000000000003:::::::::: #
:::::5000@0B0@0000000000000000000AB0B000>7;;;;;;;; #
;;;;?0003::::500000000000A0@0@0=6:::50000000>7;;;; #
;;;80000>7;;8?00@B0BA0B003::::::;;;8?000000000>7;; #
;;8?0000000000003:::::50000>7;;;;;?0000000000000>; #
;?000000000000000>;;;;?00000>;;;;;000000000000000; #