00000000000000000000000000000000000000000000000000 #
00000000000000000000000000000000000000000000000000 #
00002002000200000203:::502<00202020000000000000000 #
0000;00;000;00200;000;000;C<0;0;0;0000000000000000 #
0000;00;000;00;00;000;000;>C<;04040000000000000000 #
00007<=80007<=;<=8000;000;0>C;00000000000000000000 #
0000>78?000>78078?03:;:50400>401010000000000000000 #
<0000000000000000000000000000000000000000000000000 #
:::::::::::::::::::::::::::::::::90000000000000000 #